+--+--+--+--+--+
|              |
+     +--+--+  +
|        |     |
+  +--+  +--+  +
|  |        |  |
+--+  +--+  +  +
|     |  |     |
+  +--+  +  +--+
*        |     |
+--+--+--+--+--+